#####################
  # #     #     # # #
# # ### ##### ### # #
#     #   #         #
# ##### # # # ##### #
# # # # #   # #   # #
# # # ##### # # #####
#   # # # #         #
# ### # # ##### #####
# #       # #       #
# # # ### # ####### #
#   #   #   # #     #
# ##### ### # ### # #
# # # #   # #     # #
# # # ### ##### ### #
#   #   #   #     # #
# # ### # ### ### # #
# #   #     # #   # #
##### ##### # #######
#       #            
#####################


